1111111111111111111111111111111111
10000000000000000000000000000000P1
1001110111011101110011111111111111
10000100010001000100100000C0000001
1000010111011100010010000000000001
1000010001000100010010000000000001
1000010111011100010010000000000001
1000000000000000000000000000000001
1000000000000000000000000000000001
100000000C000000000000000000000001
1000000000000000000000000000000001
1000111110111110111110111100000001
1000100000100010100010100100000001
1000111110111110111110100100000001
1000000010100010100010100100000001
1000111110100010100010111100000001
10000000000000000000000000000C0001
1000000000000000000000000000000001
1000000C00000000000000001111111111
1000000000000000000000000000000001
1000000000000000000000000000000001
1000000000000000000000000000000001
100000000000000000000000E0000000C1
1111111111111111111111111111111111
