1111111111111111111111111111111111
1000000000000000000000000000000001
1001110111011101110011111111111111
1000010001000100010010000000000001
1000010111011100010010000000000001
1000010001000100010010000000000001
1000010111011100010010000000000001
100000000CC0C000000000000000000001
100P0C0C0C00C0C0E00000000000000001
1000000000000000000000000000000001
1000000000000000000000000000000001
1000111110111110111110111100000001
1000100000100010100010100100000001
1000111110111110111110100100000001
1000000010100010100010100100000001
1000111110100010100010111100000001
1000000000000000000000000000000001
1000000000000000000000000000000001
1000000000000000000000001111111111
1000000000000000000000000000000001
1000000000000000000000000000000001
1000000000000000000000000000000001
1000000000000000000000000000000001
1111111111111111111111111111111111
